starwars overlaps with: starwarstiktok, starwarsfan
formula1 overlaps with: formulaone
guitar overlaps with: guitartok, guitarplayer, guitarcover, guitarhero, guitarsolo, guitarra
metal overlaps with: metalcore, metalmusic, metallica, babymetal_japan, metaltok, babymetal
music overlaps with: newmusic, musica, rockmusic, livemusic
gaming overlaps with: gamingontiktok, games, game, pcgaming
guitartok overlaps with: guitar, guitarplayer, guitarcover, guitarhero, guitarsolo, guitarra
3dprinting overlaps with: 3dprint, 3dprinted
engineering overlaps with: technology, mechanicalengineering, engineer
cosplay overlaps with: cosplayer
satisfying overlaps with: satisfyingvideo
catsoftiktok overlaps with: cats
guitarist overlaps with: guitaristsoftiktok
math overlaps with: mathematics, maths
metalhead overlaps with: metalheads
anakinskywalker overlaps with: lukeskywalker
movie overlaps with: film, barbiemovie, filmtok, movies, movietok
newmusic overlaps with: musica, rockmusic, livemusic, music
metaltok overlaps with: metalcore, metalmusic, metallica, babymetal_japan, metal, babymetal
guitarsolo overlaps with: guitartok, guitar, guitarplayer, guitarcover, guitarhero, guitarra
starwarsfan overlaps with: starwarstiktok, starwars
doctorwho overlaps with: doctorwhotiktok
metallica overlaps with: metalcore, metalmusic, babymetal_japan, metal, metaltok, babymetal
lordoftherings overlaps with: band
starwarstiktok overlaps with: starwars, starwarsfan
drums overlaps with: drumming
gamingontiktok overlaps with: pcgaming, games, gaming, game
college overlaps with: collegelife
powermetal overlaps with: powerwolf
twitch overlaps with: cdawgvatwitch
formulaone overlaps with: formula1
3dprinted overlaps with: 3dprint, 3dprinting
musician overlaps with: musiciansoftiktok
history overlaps with: story, storytime
artist overlaps with: artistsoftiktok
cats overlaps with: catsoftiktok
lego overlaps with: legostarwars
streamer overlaps with: twitchstreamer
queensuniversity overlaps with: university
movies overlaps with: film, movie, barbiemovie, filmtok, movietok
university overlaps with: queensuniversity
spongebob overlaps with: spongebobsquarepants
food overlaps with: foodtiktok, foodtok
babymetal overlaps with: metalcore, metalmusic, metallica, babymetal_japan, metal, metaltok
motorsport overlaps with: beamngdrive
racing overlaps with: redbullracing, speed
cover overlaps with: aicover
game overlaps with: pcgaming, gamer, games, gaming, gamingontiktok
redbullracing overlaps with: racing, speed
space overlaps with: infinitecraft
helldivers2 overlaps with: helldivers
cartoon overlaps with: sketch
scottpilgrim overlaps with: scottpilgrimtakesoff, scottpilgrimvstheworld
drawing overlaps with: filmmaking
warhammer40k overlaps with: warhammer
adhd overlaps with: adhdtiktok
computerscience overlaps with: computer
technology overlaps with: engineering, mechanicalengineering
sketch overlaps with: cartoon
metalmusic overlaps with: metalcore, metallica, babymetal_japan, metal, metaltok, babymetal
foodtok overlaps with: foodtiktok, food
filmtok overlaps with: film, movie, barbiemovie, movies, movietok
musiciansoftiktok overlaps with: musician
eurovision overlaps with: eurovision2024
guitarcover overlaps with: guitartok, guitar, guitarplayer, guitarhero, guitarsolo, guitarra
metalcore overlaps with: metalmusic, metallica, babymetal_japan, metal, metaltok, babymetal
3dprint overlaps with: 3dprinted, 3dprinting
powerwolf overlaps with: powermetal
film overlaps with: movie, barbiemovie, filmtok, movies, movietok
guitarra overlaps with: guitartok, guitar, guitarplayer, guitarcover, guitarhero, guitarsolo
guitarplayer overlaps with: guitartok, guitar, guitarcover, guitarhero, guitarsolo, guitarra
tech overlaps with: techtok
cooking overlaps with: filmmaking
speed overlaps with: redbullracing, racing
storytime overlaps with: story, history
filmmaking overlaps with: drawing, cooking, givesyouwiiings
makeulaugh overlaps with: trynottolaugh, joke, jokes
jokes overlaps with: trynottolaugh, joke, prank, makeulaugh
satisfyingvideo overlaps with: satisfying
pcgaming overlaps with: gamingontiktok, games, gaming, game
eurovision2024 overlaps with: eurovision
song overlaps with: vocaloid
foodtiktok overlaps with: food, foodtok
vocaloid overlaps with: song
joke overlaps with: trynottolaugh, prank, jokes, makeulaugh
livemusic overlaps with: newmusic, musica, rockmusic, music
scottpilgrimvstheworld overlaps with: scottpilgrimtakesoff, scottpilgrim
techtok overlaps with: tech
doctorwhotiktok overlaps with: doctorwho
drumming overlaps with: drums
cosplayer overlaps with: cosplay
computer overlaps with: computerscience
collegelife overlaps with: college
guitarhero overlaps with: guitartok, guitar, guitarplayer, guitarcover, guitarsolo, guitarra
givesyouwiiings overlaps with: filmmaking, aigenerated
infinitecraft overlaps with: space
metalheads overlaps with: metalhead
movietok overlaps with: film, barbiemovie, filmtok, movies, movie
helldivers overlaps with: helldivers2
midjourney overlaps with: travel
aigenerated overlaps with: givesyouwiiings
gamer overlaps with: game
warhammer overlaps with: warhammer40k
rockmusic overlaps with: newmusic, musica, livemusic, music
band overlaps with: lordoftherings
engineer overlaps with: engineering, mechanicalengineering
games overlaps with: gamingontiktok, gaming, pcgaming, game
prank overlaps with: joke, jokes
pets overlaps with: muppets
mathematics overlaps with: math, maths
guitaristsoftiktok overlaps with: guitarist
adhdtiktok overlaps with: adhd
poker overlaps with: pokertok
british overlaps with: britishfood
babymetal_japan overlaps with: metalcore, metalmusic, metallica, metal, metaltok, babymetal
legostarwars overlaps with: lego
clips overlaps with: cdawgvaclips
aicover overlaps with: cover
trynottolaugh overlaps with: joke, jokes, makeulaugh
beamngdrive overlaps with: motorsport
muppets overlaps with: pets
lukeskywalker overlaps with: anakinskywalker
travel overlaps with: midjourney
mechanicalengineering overlaps with: engineering, technology, engineer
scottpilgrimtakesoff overlaps with: scottpilgrimvstheworld, scottpilgrim
spongebobsquarepants overlaps with: spongebob
barbiemovie overlaps with: film, movie, filmtok, movies, movietok
musica overlaps with: newmusic, rockmusic, livemusic, music
britishfood overlaps with: british
cdawgvatwitch overlaps with: twitch
cdawgvaclips overlaps with: clips
artistsoftiktok overlaps with: artist
maths overlaps with: math, mathematics
story overlaps with: storytime, history
twitchstreamer overlaps with: streamer
pokertok overlaps with: poker
